155555555555555555555555555555555555552
7#####################################8
7#####################################8
7#####################################8
7#####################################8
7#####################################8
7#####################################8
7#####################################8
7#####################################8
7#####################################8
7#####################################8
7#####################################8
7#####################################8
7#####################################8
7#####################################8
7#####################################8
7#####################################8
7#####################################8
7#####################################8
7#####################################8
7#####################################8
7#####################################8
7#####################################8
366666666666666666666666666666666666664
